00000000000000000000000000-
00000000000000000000000000-
00455300004555300004553000-
00600600006000600006006000-
00600600006000600006006000-
00600600006000600006006000-
55100600006000600006006000-
00000600006000600006006000-
00000600006000600006006000-
00000600006000600006006000-
00000255551000255551002555-
00000000000000000000000000-
00000000000000000000000000